BJCD,NAME
"1111000000",종로구
"1114000000",중구
"1117000000",용산구
"1120000000",성동구
"1121500000",광진구
"1123000000",동대문구
"1126000000",중랑구
"1129000000",성북구
"1130500000",강북구
"1132000000",도봉구
"1135000000",노원구
"1138000000",은평구
"1141000000",서대문구
"1144000000",마포구
"1147000000",양천구
"1150000000",강서구
"1153000000",구로구
"1154500000",금천구
"1156000000",영등포구
"1159000000",동작구
"1162000000",관악구
"1165000000",서초구
"1168000000",강남구
"1171000000",송파구
"1174000000",강동구
"2611000000",중구
"2614000000",서구
"2617000000",동구
"2620000000",영도구
"2623000000",부산진구
"2626000000",동래구
"2629000000",남구
"2632000000",북구
"2635000000",해운대구
"2638000000",사하구
"2641000000",금정구
"2644000000",강서구
"2647000000",연제구
"2650000000",수영구
"2653000000",사상구
"2671000000",기장군
"2711000000",중구
"2714000000",동구
"2717000000",서구
"2720000000",남구
"2723000000",북구
"2726000000",수성구
"2729000000",달서구
"2771000000",달성군
"2772000000",군위군
"2811000000",중구
"2814000000",동구
"2817700000",미추홀구
"2818500000",연수구
"2820000000",남동구
"2823700000",부평구
"2824500000",계양구
"2826000000",서구
"2871000000",강화군
"2872000000",옹진군
"2911000000",동구
"2914000000",서구
"2915500000",남구
"2917000000",북구
"2920000000",광산구
"3011000000",동구
"3014000000",중구
"3017000000",서구
"3020000000",유성구
"3023000000",대덕구
"3111000000",중구
"3114000000",남구
"3117000000",동구
"3120000000",북구
"3171000000",울주군
"3611000000",세종특별자치시
"4111000000",수원시
"4111100000",장안구
"4111300000",권선구
"4111500000",팔달구
"4111700000",영통구
"4113000000",성남시
"4113100000",수정구
"4113300000",중원구
"4113500000",분당구
"4115000000",의정부시
"4117000000",안양시
"4117100000",만안구
"4117300000",동안구
"4119000000",부천시
"4119200000",원미구
"4119400000",소사구
"4119600000",오정구
"4121000000",광명시
"4122000000",평택시
"4125000000",동두천시
"4127000000",안산시
"4127100000",상록구
"4127300000",단원구
"4128000000",고양시
"4128100000",덕양구
"4128500000",일산동구
"4128700000",일산서구
"4129000000",과천시
"4131000000",구리시
"4136000000",남양주시
"4137000000",오산시
"4139000000",시흥시
"4141000000",군포시
"4143000000",의왕시
"4145000000",하남시
"4146000000",용인시
"4146100000",처인구
"4146300000",기흥구
"4146500000",수지구
"4148000000",파주시
"4150000000",이천시
"4155000000",안성시
"4157000000",김포시
"4159000000",화성시
"4161000000",광주시
"4163000000",양주시
"4165000000",포천시
"4167000000",여주시
"4180000000",연천군
"4182000000",가평군
"4183000000",양평군
"4311000000",청주시
"4311100000",상당구
"4311200000",서원구
"4311300000",흥덕구
"4311400000",청원구
"4313000000",충주시
"4315000000",제천시
"4372000000",보은군
"4373000000",옥천군
"4374000000",영동군
"4374500000",증평군
"4375000000",진천군
"4376000000",괴산군
"4377000000",음성군
"4380000000",단양군
"4413000000",천안시
"4413100000",동남구
"4413300000",서북구
"4415000000",공주시
"4418000000",보령시
"4420000000",아산시
"4421000000",서산시
"4423000000",논산시
"4425000000",계룡시
"4427000000",당진시
"4471000000",금산군
"4476000000",부여군
"4477000000",서천군
"4479000000",청양군
"4480000000",홍성군
"4481000000",예산군
"4482500000",태안군
"4611000000",목포시
"4613000000",여수시
"4615000000",순천시
"4617000000",나주시
"4623000000",광양시
"4671000000",담양군
"4672000000",곡성군
"4673000000",구례군
"4677000000",고흥군
"4678000000",보성군
"4679000000",화순군
"4680000000",장흥군
"4681000000",강진군
"4682000000",해남군
"4683000000",영암군
"4684000000",무안군
"4686000000",함평군
"4687000000",영광군
"4688000000",장성군
"4689000000",완도군
"4690000000",진도군
"4691000000",신안군
"4711000000",포항시
"4711100000",남구
"4711300000",북구
"4713000000",경주시
"4715000000",김천시
"4717000000",안동시
"4719000000",구미시
"4721000000",영주시
"4723000000",영천시
"4725000000",상주시
"4728000000",문경시
"4729000000",경산시
"4773000000",의성군
"4775000000",청송군
"4776000000",영양군
"4777000000",영덕군
"4782000000",청도군
"4783000000",고령군
"4784000000",성주군
"4785000000",칠곡군
"4790000000",예천군
"4792000000",봉화군
"4793000000",울진군
"4794000000",울릉군
"4812000000",창원시
"4812100000",의창구
"4812300000",성산구
"4812500000",마산합포구
"4812700000",마산회원구
"4812900000",진해구
"4817000000",진주시
"4822000000",통영시
"4824000000",사천시
"4825000000",김해시
"4827000000",밀양시
"4831000000",거제시
"4833000000",양산시
"4872000000",의령군
"4873000000",함안군
"4874000000",창녕군
"4882000000",고성군
"4884000000",남해군
"4885000000",하동군
"4886000000",산청군
"4887000000",함양군
"4888000000",거창군
"4889000000",합천군
"5011000000",제주시
"5013000000",서귀포시
"5111000000",춘천시
"5113000000",원주시
"5115000000",강릉시
"5117000000",동해시
"5119000000",태백시
"5121000000",속초시
"5123000000",삼척시
"5172000000",홍천군
"5173000000",횡성군
"5175000000",영월군
"5176000000",평창군
"5177000000",정선군
"5178000000",철원군
"5179000000",화천군
"5180000000",양구군
"5181000000",인제군
"5182000000",고성군
"5183000000",양양군
"5211000000",전주시
"5211100000",완산구
"5211300000",덕진구
"5213000000",군산시
"5214000000",익산시
"5218000000",정읍시
"5219000000",남원시
"5221000000",김제시
"5271000000",완주군
"5272000000",진안군
"5273000000",무주군
"5274000000",장수군
"5275000000",임실군
"5277000000",순창군
"5279000000",고창군
"5280000000",부안군
